111111111111111111111111111111111111111111111111111111111111
1P1100000000000000000000000000000000000000000000000000000001
101111110101111111111111111111111111111111111111111111111101
100000000000000000000000000000000000000000000000000000000001
101110111111111111111111111111111111111111111111111111111101
101100000000000000000000000000000000000000000000000000000001
100101111111111111111111111111111111111111111111111111111001
100101000000000000000000000000000000000000000000000000000001
101111111111111111111111111111111111111111111111111111111101
100000000000000000000000000000000000000000000000000000000001
101111111111111111111111111111111111111111111111111111111101
100000000000000000000000000000000000000000000000000000000001
101100111100001010100010CCC01110110000CCCC000010000001000001
1011011111111010101111111111110111111111CCCC1C11111011111101
101101000CCCCC10101C1100000000000CCCC00000000000000000000001
100000000000000000000000CCC000000000000000000000000000000001
111111111111111111111111111111111111111011111111111111111111
1000000000000000000000C0000000000000000000000000000000000001
101110111111111111111111111111111111111111111111111111111101
101100000000000000000000000000000000000000000000000000000001
100101111111111111111111111111111111111111111111111111111001
10010100000000000C000000000000000000000000000000000000000001
101111111111111111111111111111111111111111111111111111111101
100000000000000000000000000000000000000000000000000000000001
101111111111111111111111111111111111111111111111111111111101
100000000000000000000000000000000000000000000000000000000001
101100111100CC101C100010000011101100000000000010000001000001
101101111111101010111111111111011111111100001011111011111101
101101000000001010101100000000000000000000000000000000000001
1000000000000000000000000000000000000000000000000000000000E1
111111111111111111111111111111111111111111111111111111111111
