1111111111111
1111111111111
10010000000C1
10M00100M0001
1P001100000E1
11C1111111111
1111111111111
